"x","y","width","height"
"100","780","25","100"
"350","720","25","20"
"540","310","25","20"
"600","660","25","20"
"850","600","25","20"
"650","460","25","20"
"660","170","25","20"
"760","310","25","20"
